#####################################
#                               ..  #
#############.#######################
#                                   #
#                     #####      .  #
################################    #
#                                   #
#   #  .               .            #
#   #                               #
#####################################